Hans Landa - Christoph Waltz - Inglourious Basterds
Tony Stark - RDJ - Marvel Cinematic Universe
Major Marquis Warren - Samuel L. Jackson - The Hateful Eight
The Joker  - Heath Ledger - The Dark Knight
Forrest Gump - Tom Hanks - Forrest Gump
Darth Vader - James Earl Jones - Star Wars Episodes IV - VI
Walter White - Bryan Cranston (Breaking Bad)
Hannibal Lecter - Anthony Hopkins (Silence of the Lambs)
Super Hans - Matt King (Peep Show)
Aragorn - Viggo Mortensen (Lord of the Rings)
Jim Bell - Mark Heap (Friday Night Dinner)
'Red' - Morgan Freeman (The Shawshank Redemption)
Jordan Belfort - DiCaprio - The Wolf of Wall Street
Hannibal - Mads Mikkelsen - Hannibal
Saitama - Anime (Japanese with sub) - One Punch Man
Scott Pilgrim - Micheal Cera - Scott Pilgrim vs the World
Rick - Justin Roiland - Rick and Morty
Cantina Band - Alien bois - Star Wars: Episode IV
Patrick Star - Animoo - Spoongybobble
Sherlock - Benedict - TV
Batman - Dark knight franchise
Ryuk - Death note - TV
mufasa - Lion King
Lightning McQueen - Cars
Spider pig - Simpsons Movie/ series
Loki - Marvel franchise
Leopold Fitz - Agents of Shield
Captain Raymond Holt - Brooklyn Nine Nine
Doctor Strange - Marvel's Doctor Strange
11th Doctor (Matt Smith) - Doctor Who
Shuri - Marvel's Black Panther
Kilgrave - Jessica Jones